XXXXXXXXXXXXXXXXXXXXXXXXXXXXXXXXXXXXXXXXXXXXXXXXXXXXXXXXXXXXXXXXXXXXXXXXXXXXXXXXXXXXXXXXXXXXXXXXXXXX
XXXXXXXXXXXXXXXXXXXXXXXXXXXXXXXXXXXXXXXXXXXXXXXXXXXXXXXXXXXXXXXXXXXXXXXXXXXXXXXXXXXXXXXXXXXXXXXXXXXX
XXXXXXXXXXXXXXXXXXXXXXXXXXXXXXXXXXXXXXXXXXXXXXXXXXXXXXXXXXXXXXXXXXXXXXXXXXXXXXXXXXXXXXXXXXXXXXXXXXXX
XXXCCCCCCCCCCCCCCCCCCCCCCCCCCCCCCCCCCCCCCCCCCCCCCCCCCCCCCCCCCCCCCCCCCCCCCCCCCCCCCCCCCCCCCCCCCCCCCXXX
XXXCCCCCCCCCCCCCCCCCCCCCCCCCCCCCCCCCCCCCCCCCCCCCCCCCCCCCCCCCCCCCCCCCCCCCCCCCCCCCCCCCCCCCCCCCCCCCCXXX
XXXCCCCCCCCCCCCCCCCCCCCCCCCCCCCCCCCCCCCCCCCCCCCCCCCCCCCCCCCCCCCCCCCCCCCCCCCCCCCCCCCCCCCCCCCCCCCCCXXX
XXXCCCCCCCCCCCCCCCCCCCCCCCCCCCCCCCCCCCCCCCCCCCCCCCCCCCCCCCCCCCCCCCCCCCCCCCCCCCCCCCCCCCCCCCCCCCCCCXXX
XXXCCCCCCCCCCCCCCCCCCCCCCCCCCCCCCCCCCCCCCCCCCCCCCCCCCCCCCCCCCCCCCCCCCCCCCCCCCCCCCCCCCCCCCCCCCCCCCXXX
XXXCCCCCCCCCCCCCCCCCCCCCCCCCCCCCCCCCCCCCCCCCCCCCCCCCCCCCCCCCCCCCCCCCCCCCCCCCCCCCCCCCCCCCCCCCCCCCCXXX
XXXCCCCCCCCCCCCCCCCCCCCCCCCCCCCCCCCCCCCCCCCCCCCCCCCCCCCCCCCCCCCCCCCCCCCCCCCCCCCCCCCCCCCCCCCCCCCCCXXX
XXXCCCCCCCCCCCCCCCCCCCCCCCCCCCCCCCCCCCCCCCCCCCCCCCCCCCCCCCCCCCCCCCCCCCCCCCCCCCCCCCCCCCCCCCCCCCCCCXXX
XXXCCCCCCCCCCCCCCCCCCCCCCCCCCCCCCCCCCCCCCCCCCCCCCCCCCCCCCCCCCCCCCCCCCCCCCCCCCCCCCCCCCCCCCCCCCCCCCXXX
XXXCCCCCCCCCCCCCCCCCCCCCCCCCCCCCCCCCCCCCCCCCCCCCCCCCCCCCCCCCCCCCCCCCCCCCCCCCCCCCCCCCCCCCCCCCCCCCCXXX
XXXCCCCCCCCCCCCCCCCCCCCCCCCCCCCCCCCCCCCCCCCCCCCCCCCCCCCCCCCCCCCCCCCCCCCCCCCCCCCCCCCCCCCCCCCCCCCCCXXX
XXXCCCCCCCCCCCCCCCCCCCCCCCCCCCCCCCCCCCCCCCCCCCCCCCCCCCCCCCCCCCCCCCCCCCCCCCCCCCCCCCCCCCCCCCCCCCCCCXXX
XXXCCCCCCCCCCCCCCCCCCCCCCCCCCCCCCCCCCCCCCCCCCCCCCCCCCCCCCCCCCCCCCCCCCCCCCCCCCCCCCCCCCCCCCCCCCCCCCXXX
XXXCCCCCCCCCCCCCCCCCCCCCCCCCCCCCCCCCCCCCCCCCCCCCCCCCCCCCCCCCCCCCCCCCCCCCCCCCCCCCCCCCCCCCCCCCCCCCCXXX
XXXCCCCCCCCCCCCCCCCCCCCCCCCCCCCCCCCCCCCCCCCCCCCCCCCCCCCCCCCCCCCCCCCCCCCCCCCCCCCCCCCCCCCCCCCCCCCCCXXX
XXXCCCCCCCCCCCCCCCCCCCCCCCCCCCCCCCCCCCCCCCCCCCCCCCCCCCCCCCCCCCCCCCCCCCCCCCCCCCCCCCCCCCCCCCCCCCCCCXXX
XXXCCCCCCCCCCCCCCCCCCCCCCCCCCCCCCCCCCCCCCCCCCCCCCCCCCCCCCCCCCCCCCCCCCCCCCCCCCCCCCCCCCCCCCCCCCCCCCXXX
XXXCCCCCCCCCCCCCCCCCCCCCCCCCCCCCCCCCCCCCCCCCCCCCCCCCCCCCCCCCCCCCCCCCCCCCCCCCCCCCCCCCCCCCCCCCCCCCCXXX
XXXCCCCCCCCCCCCCCCCCCCCCCCCCCCCCCCCCCCCCCCCCCCCCCCCCCCCCCCCCCCCCCCCCCCCCCCCCCCCCCCCCCCCCCCCCCCCCCXXX
XXXCCCCCCCCCCCCCCCCCCCCCCCCCCCCCCCCCCCCCCCCCCCCCCCCCCCCCCCCCCCCCCCCCCCCCCCCCCCCCCCCCCCCCCCCCCCCCCXXX
XXXCCCCCCCCCCCCCCCCCCCCCCCCCCCCCCCCCCCCCCCCCCCCCCCCCCCCCCCCCCCCCCCCCCCCCCCCCCCCCCCCCCCCCCCCCCCCCCXXX
XXXCCCCCCCCCCCCCCCCCCCCCCCCCCCCCCCCCCCCCCCCCCCCCCaaaaaaaCCCCCCCCCCCCCCCCCCCCCCCCCCCCCCCCCCCCCCCCCXXX
XXXCCCCCCCCCCCCCCCCCCCCCCCCCCCCCCCCCCCCCCCaaaaaaaaaaaaaaaaaaaCCCCCCCCCCCCCCCCCCCCCCCCCCCCCCCCCCCCXXX
XXXCCCCCCCCCCCCCCCCCCCCCCCCCCCCCCCCCCCCaaaaaaaaaaaaaaaaaaaaaaaaaCCCCCCCCCCCCCCCCCCCCCCCCCCCCCCCCCXXX
XXXCCCCCCCCCCCCCCCCCCCCCCCCCCCCCCCCCaaaaaaaaaaaaaaaaaaaaaaaaaaaaaaCCCCCCCCCCCCCCCCCCCCCCCCCCCCCCCXXX
XXXCCCCCCCCCCCCCCCCCCCCCCCCCCCCCCCaaaaaaaaaaaaaaaaaaaaaaaaaaaaaaaaaCCCCCCCCCCCCCCCCCCCCCCCCCCCCCCXXX
XXXCCCCCCCCCCCCCCCCCCCCCCCCCCCCCaaaaaaaaaaaaa####...#####aaaaaaaaaaaaCCCCCCCCCCCCCCCCCCCCCCCCCCCCXXX
XXXCCCCCCCCCCCCCCCCCCCCCCCCCCCCaaaaaaaaaa########...#########aaaaaaaaaaCCCCCCCCCCCCCCCCCCCCCCCCCCXXX
XXXCCCCCCCCCCCCCCCCCCCCCCCCCCCaaaaaaaaa##########...###########aaaaaaaaaCCCCCCCCCCCCCCCCCCCCCCCCCXXX
XXXCCCCCCCCCCCCCCCCCCCCCCCCCCaaaaaaaa############...#############aaaaaaaCCCCCCCCCCCCCCCCCCCCCCCCCXXX
XXXCCCCCCCCCCCCCCCCCCCCCCCCCaaaaaaaa#############...##############aaaaaaaCCCCCCCCCCCCCCCCCCCCCCCCXXX
XXXCCCCCCCCCCCCCCCCCCCCCCCCCaaaaaaa##############...###############aaaaaaaCCCCCCCCCCCCCCCCCCCCCCCXXX
XXXCCCCCCCCCCCCCCCCCCCCCCCCCaaaaaa###############...################aaaaaaCCCCCCCCCCCCCCCCCCCCCCCXXX
XXXCCCCCCCCCCCCCCCCCCCCCCCCaaaaaa################...#################aaaaaaCCCCCCCCCCCCCCCCCCCCCCXXX
XXXCCCCCCCCCCCCCCCCCCCCCCCaaaaaa#################...##################aaaaaCCCCCCCCCCCCCCCCCCCCCCXXX
XXXCCCCCCCCCCCCCCCCCCCCCCCaaaaa##################...###################aaaaCCCCCCCCCCCCCCCCCCCCCCXXX
XXXCCCCCCCCCCCCCCCCCCCCCCCaaaa###################...####################aaaaCCCCCCCCCCCCCCCCCCCCCXXX
XXXCCCCCCCCCCCCCCCCCCCCCCCaaaa###################...####################aaaaCCCCCCCCCCCCCCCCCCCCCXXX
XXXCCCCCCCCCCCCCCCCCCCCCCaaaa####################...#####################aaaaCCCCCCCCCCCCCCCCCCCCXXX
XXXCCCCCCCCCCCCCCCCCCCCCCaaaa####################...#####################aaaaCCCCCCCCCCCCCCCCCCCCXXX
XXXCCCCCCCCCCCCCCCCCCCCCCaaa#####################...######################aaaCCCCCCCCCCCCCCCCCCCCXXX
XXXCCCCCCCCCCCCCCCCCCCCCaaaa#####################...######################aaaaCCCCCCCCCCCCCCCCCCCXXX
XXXCCCCCCCCCCCCCCCCCCCCCaaa######################...#######################aaaCCCCCCCCCCCCCCCCCCCXXX
XXXCCCCCCCCCCCCCCCCCCCCCaaa######################...#######################aaaCCCCCCCCCCCCCCCCCCCXXX
XXXCCCCCCCCCCCCCCCCCCCCCaaa######################...#####^^^^^^^^##########aaaCCCCCCCCCCCCCCCCCCCXXX
XXXCCCCCCCCCCCCCCCCCCCCCaaa######################...#####^^^^^^^^##########aaaCCCCCCCCCCCCCCCCCCCXXX
XXXCCCCCCCCCCCCCCCCCCCCCaaa######################...#####^^^^^^^^##########aaaCCCCCCCCCCCCCCCCCCCXXX
XXXCCCCCCCCCCCCCCCCCCCCCaaa######################...#####^^^^^^^^##########aaaCCCCCCCCCCCCCCCCCCCXXX
XXXCCCCCCCCCCCCCCCCCCCCCaaa######################...#####^^^^^^^^##########aaaCCCCCCCCCCCCCCCCCCCXXX
XXXCCCCCCCCCCCCCCCCCCCCCaaa######################...#####^^^^^^^^##########aaaCCCCCCCCCCCCCCCCCCCXXX
XXXCCCCCCCCCCCCCCCCCCCCCaaa######################...#####^^^^^^^^##########aaaCCCCCCCCCCCCCCCCCCCXXX
XXXCCCCCCCCCCCCCCCCCCCCCaaa######################...#####^^^^^^^^##########aaaCCCCCCCCCCCCCCCCCCCXXX
XXXCCCCCCCCCCCCCCCCCCCCCaaa######################...#######################aaaCCCCCCCCCCCCCCCCCCCXXX
XXXCCCCCCCCCCCCCCCCCCCCCaaa######################...#######################aaaCCCCCCCCCCCCCCCCCCCXXX
XXXCCCCCCCCCCCCCCCCCCCCCaaaa#####################...######################aaaaCCCCCCCCCCCCCCCCCCCXXX
XXXCCCCCCCCCCCCCCCCCCCCCCaaa#####################...######################aaaCCCCCCCCCCCCCCCCCCCCXXX
XXXCCCCCCCCCCCCCCCCCCCCCCaaaa####################...#####################aaaaCCCCCCCCCCCCCCCCCCCCXXX
XXXCCCCCCCCCCCCCCCCCCCCCCaaaa####################...#####################aaaaCCCCCCCCCCCCCCCCCCCCXXX
XXXCCCCCCCCCCCCCCCCCCCCCCCaaaa###################...####################aaaaCCCCCCCCCCCCCCCCCCCCCXXX
XXXCCCCCCCCCCCCCCCCCCCCCCCaaaa###################...####################aaaaCCCCCCCCCCCCCCCCCCCCCXXX
XXXCCCCCCCCCCCCCCCCCCCCCCCCaaaa##################...###################aaaaCCCCCCCCCCCCCCCCCCCCCCXXX
XXXCCCCCCCCCCCCCCCCCCCCCCCCaaaaa#################...##################aaaaaCCCCCCCCCCCCCCCCCCCCCCXXX
XXXCCCCCCCCCCCCCCCCCCCCCCCCCaaaaa################...#################aaaaaCCCCCCCCCCCCCCCCCCCCCCCXXX
XXXCCCCCCCCCCCCCCCCCCCCCCCCCCaaaaa###############...################aaaaaCCCCCCCCCCCCCCCCCCCCCCCCXXX
XXXCCCCCCCCCCCCCCCCCCCCCCCCCCCaaaaa##############...###############aaaaaCCCCCCCCCCCCCCCCCCCCCCCCCXXX
XXXCCCCCCCCCCCCCCCCCCCCCCCCCCCCaaaaa#############...##############aaaaaCCCCCCCCCCCCCCCCCCCCCCCCCCXXX
XXXCCCCCCCCCCCCCCCCCCCCCCCCCCCCCaaaaa############...#############aaaaaCCCCCCCCCCCCCCCCCCCCCCCCCCCXXX
XXXCCCCCCCCCCCCCCCCCCCCCCCCCCCCCCaaaaaa##########...###########aaaaaaCCCCCCCCCCCCCCCCCCCCCCCCCCCCXXX
XXXCCCCCCCCCCCCCCCCCCCCCCCCCCCCCCCaaaaaaa########...#########aaaaaaaCCCCCCCCCCCCCCCCCCCCCCCCCCCCCXXX
XXXCCCCCCCCCCCCCCCCCCCCCCCCCCCCCCCCCaaaaaaaaa####...#####aaaaaaaaaCCCCCCCCCCCCCCCCCCCCCCCCCCCCCCCXXX
XXXCCCCCCCCCCCCCCCCCCCCCCCCCCCCCCCCCCCaaaaaaaaaaaaaaaaaaaaaaaaaaCCCCCCCCCCCCCCCCCCCCCCCCCCCCCCCCCXXX
XXXCCCCCCCCCCCCCCCCCCCCCCCCCCCCCCCCCCCCCaaaaaaaaaaaaaaaaaaaaaaCCCCCCCCCCCCCCCCCCCCCCCCCCCCCCCCCCCXXX
XXXCCCCCCCCCCCCCCCCCCCCCCCCCCCCCCCCCCCCCCCCaaaaaaaaaaaaaaaaCCCCCCCCCCCCCCCCCCCCCCCCCCCCCCCCCCCCCCXXX
XXXCCCCCCCCCCCCCCCCCCCCCCCCCCCCCCCCCCCCCCCCCCCCCCCCCCCCCCCCCCCCCCCCCCCCCCCCCCCCCCCCCCCCCCCCCCCCCCXXX
XXXCCCCCCCCCCCCCCCCCCCCCCCCCCCCCCCCCCCCCCCCCCCCCCCCCCCCCCCCCCCCCCCCCCCCCCCCCCCCCCCCCCCCCCCCCCCCCCXXX
XXXCCCCCCCCCCCCCCCCCCCCCCCCCCCCCCCCCCCCCCCCCCCCCCCCCCCCCCCCCCCCCCCCCCCCCCCCCCCCCCCCCCCCCCCCCCCCCCXXX
XXXCCCCCCCCCCCCCCCCCCCCCCCCCCCCCCCCCCCCCCCCCCCCCCCCCCCCCCCCCCCCCCCCCCCCCCCCCCCCCCCCCCCCCCCCCCCCCCXXX
XXXCCCCCCCCCCCCCCCCCCCCCCCCCCCCCCCCCCCCCCCCCCCCCCCCCCCCCCCCCCCCCCCCCCCCCCCCCCCCCCCCCCCCCCCCCCCCCCXXX
XXXCCCCCCCCCCCCCCCCCCCCCCCCCCCCCCCCCCCCCCCCCCCCCCCCCCCCCCCCCCCCCCCCCCCCCCCCCCCCCCCCCCCCCCCCCCCCCCXXX
XXXCCCCCCCCCCCCCCCCCCCCCCCCCCCCCCCCCCCCCCCCCCCCCCCCCCCCCCCCCCCCCCCCCCCCCCCCCCCCCCCCCCCCCCCCCCCCCCXXX
XXXCCCCCCCCCCCCCCCCCCCCCCCCCCCCCCCCCCCCCCCCCCCCCCCCCCCCCCCCCCCCCCCCCCCCCCCCCCCCCCCCCCCCCCCCCCCCCCXXX
XXXCCCCCCCCCCCCCCCCCCCCCCCCCCCCCCCCCCCCCCCCCCCCCCCCCCCCCCCCCCCCCCCCCCCCCCCCCCCCCCCCCCCCCCCCCCCCCCXXX
XXXCCCCCCCCCCCCCCCCCCCCCCCCCCCCCCCCCCCCCCCCCCCCCCCCCCCCCCCCCCCCCCCCCCCCCCCCCCCCCCCCCCCCCCCCCCCCCCXXX
XXXCCCCCCCCCCCCCCCCCCCCCCCCCCCCCCCCCCCCCCCCCCCCCCCCCCCCCCCCCCCCCCCCCCCCCCCCCCCCCCCCCCCCCCCCCCCCCCXXX
XXXCCCCCCCCCCCCCCCCCCCCCCCCCCCCCCCCCCCCCCCCCCCCCCCCCCCCCCCCCCCCCCCCCCCCCCCCCCCCCCCCCCCCCCCCCCCCCCXXX
XXXCCCCCCCCCCCCCCCCCCCCCCCCCCCCCCCCCCCCCCCCCCCCCCCCCCCCCCCCCCCCCCCCCCCCCCCCCCCCCCCCCCCCCCCCCCCCCCXXX
XXXCCCCCCCCCCCCCCCCCCCCCCCCCCCCCCCCCCCCCCCCCCCCCCCCCCCCCCCCCCCCCCCCCCCCCCCCCCCCCCCCCCCCCCCCCCCCCCXXX
XXXCCCCCCCCCCCCCCCCCCCCCCCCCCCCCCCCCCCCCCCCCCCCCCCCCCCCCCCCCCCCCCCCCCCCCCCCCCCCCCCCCCCCCCCCCCCCCCXXX
XXXCCCCCCCCCCCCCCCCCCCCCCCCCCCCCCCCCCCCCCCCCCCCCCCCCCCCCCCCCCCCCCCCCCCCCCCCCCCCCCCCCCCCCCCCCCCCCCXXX
XXXCCCCCCCCCCCCCCCCCCCCCCCCCCCCCCCCCCCCCCCCCCCCCCCCCCCCCCCCCCCCCCCCCCCCCCCCCCCCCCCCCCCCCCCCCCCCCCXXX
XXXCCCCCCCCCCCCCCCCCCCCCCCCCCCCCCCCCCCCCCCCCCCCCCCCCCCCCCCCCCCCCCCCCCCCCCCCCCCCCCCCCCCCCCCCCCCCCCXXX
XXXCCCCCCCCCCCCCCCCCCCCCCCCCCCCCCCCCCCCCCCCCCCCCCCCCCCCCCCCCCCCCCCCCCCCCCCCCCCCCCCCCCCCCCCCCCCCCCXXX
XXXCCCCCCCCCCCCCCCCCCCCCCCCCCCCCCCCCCCCCCCCCCCCCCCCCCCCCCCCCCCCCCCCCCCCCCCCCCCCCCCCCCCCCCCCCCCCCCXXX
XXXCCCCCCCCCCCCCCCCCCCCCCCCCCCCCCCCCCCCCCCCCCCCCCCCCCCCCCCCCCCCCCCCCCCCCCCCCCCCCCCCCCCCCCCCCCCCCCXXX
XXXXXXXXXXXXXXXXXXXXXXXXXXXXXXXXXXXXXXXXXXXXXXXXXXXXXXXXXXXXXXXXXXXXXXXXXXXXXXXXXXXXXXXXXXXXXXXXXXXX
XXXXXXXXXXXXXXXXXXXXXXXXXXXXXXXXXXXXXXXXXXXXXXXXXXXXXXXXXXXXXXXXXXXXXXXXXXXXXXXXXXXXXXXXXXXXXXXXXXXX
XXXXXXXXXXXXXXXXXXXXXXXXXXXXXXXXXXXXXXXXXXXXXXXXXXXXXXXXXXXXXXXXXXXXXXXXXXXXXXXXXXXXXXXXXXXXXXXXXXXX
